12,12
1,1
WWWWWWWWWWWW
WILLLWLLLLLW
WLLLLWLLLLLW
WLLLLWLLLLLW
WLLLLWLLLLLW
WLLLLWLLLLLW
WLLLLWLLLLLW
WLLLLWLLLLLW
WLLLLWLLLLLW
WLLLLWLLLLLW
WLLLLLLLLLLW
WWWWWWWWWWWW
