12,12
1,1
WWWWWWWWWWWW
WIWLLLLWLLLW
WLWLLWLWLWLW
WLWLLWLWLWLW
WLWLLWLWLWLW
WLWLLWLWLWLW
WLWLLWLWLWLW
WLWLLWLWLWLW
WLWLLWLWLWLW
WLWLLWLWLWLW
WLWLLWLLLWFW
WWWWWWWWWWWW
