12,12
1,1
WWWWWWWWWWWW
WILLLLLLLLLW
WLLLLWLLLLLW
WLLLLWLLLLLW
WLLLLWLLLLLW
WLLLLWLLLLLW
WLLLLWLLLLLW
WLLLLWLLLLLW
WLLLLWLLLLLW
WLLLLWLLLLLW
WLLLLWLLLLFW
WWWWWWWWWWWW
