12,12
1,1	
WWWWWWWWWWWW
WILLLLLLLLLW
WLLLLLLLLLLW
WLLLLLLLLLLW
WLLLLLLLLLLW
WLLLLLLLLLLW
WLLLLLLLLLLW
WLLLLLLLLLLW
WLLLLLLLLLLW
WLLLLLLLLLLW
WLLLLLLLLLFW
WWWWWWWWWWWW
