12,12
1,1
WWWWWWWWWWW
WIWLLLLWLLLW
WLWLLWLWLWLW
WLWLLWLWLWLW
WLWLLWLWLWLW
WLWLLWLWLWLW
WLWLLWLWLWLW
WLWLLWLWLWLW
WLWLLWLWLWLW
WLWLLWLWLWLW
WWLLLWLLLWFW
WWWWWWWWWWWW
