12,12
1,1	
WWWWWWWWWWWW
WIWLLLLLLLLW
WWLLLLLLLLLW
WLLLLLLLLLLW
WLLLLLLLLLLW
WLLLLLLLLLLW
WLLLLLLLLLLW
WLLLLLLLLLLW
WLLLLLLLLLLW
WLLLLLLLLLLW
WLLLLLLLLLFW
WWWWWWWWWWWW
