10,10
1,1
WWWWWWWWWWWW
WIWLLLLWLLLW
WLWLLWLWLWLW
WLWLLWLWLWLW
WLWLLWLWLWLW
WLWLLWLWLWLW
WLWLLWLWLWLW
WLWLLWLWLWLW
WLWLLWLWLWLW
WLWLLWLWLWLW
WLLLLWLLLWFW
WWWWWWWWWWWW
