61,61
1,1
WWWWWWWWWWWWWWWWWWWWWWWWWWWWWWWWWWWWWWWWWWWWWWWWWWWWWWWWWWWWW
WILLWLLLLLWLLLWLLLWLLLLLWLLLWLLLLLWLLLWLLLWLLLLLLLLLLLLLWLLLW
WLWLWLWWWLWLWLWLWLWLWWWLWLWWWLWWWLWLWLWLWLWLWWWWWWWWWWWLWLWLW
WLWLWLWLLLWLWLWLWLLLWLWLWLLLLLWLWLWLWLWLWLWLWLLLWLLLLLLLWLWLW
WLWWWLWLWWWWWLWLWWWWWLWLWWWWWWWLWLWLWLWWWLWLWLWLWLWWWWWWWLWLW
WLLLLLWLLLWLLLWLLLLLWLLLLLWLLLWLWLLLWLWLLLWLWLWLLLWLLLLLLLWLW
WWWWWWWWWLWLWWWLWWWLWWWWWWWLWLWLWWWWWLWLWWWLWLWWWWWLWWWWWWWLW
WLWLLLWLLLWLWLLLWLWLLLWLWLLLWLWLLLLLWLWLLLLLWLLLLLLLWLLLWLLLW
WLWLWLWLWWWLWLWWWLWWWLWLWLWWWLWWWWWLWLWWWLWWWWWWWWWWWLWLWLWWW
WLWLWLLLWLLLWLLLLLWLLLLLWLLLWLLLLLLLLLLLWLWLLLLLLLWLLLWLLLLLW
WLWLWWWWWLWWWWWWWLWLWWWWWWWLWWWWWWWLWWWLWLWLWWWWWLWWWLWWWLWWW
WLLLLLLLLLWLLLWLLLWLLLLLWLLLWLLLWLWLWLLLWLLLWLLLLLLLWLLLWLLLW
WLWWWWWWWWWLWLWLWWWWWWWLWWWLWLWLWLWLWWWWWWWWWLWWWWWLWWWWWWWLW
WLLLLLLLLLWLWLWLLLWLWLLLWLLLWLWLLLWLLLLLWLLLWLWLLLLLLLLLWLLLW
WWWWWWWWWLWLWWWWWLWLWLWWWLWWWLWWWWWWWWWLWWWLWLWLWWWWWWWLWLWWW
WLWLLLLLLLWLLLLLLLWLLLWLWLWLWLWLLLLLLLLLWLLLLLWLWLLLLLWLWLWLW
WLWLWWWWWWWWWWWWWWWLWLWLWLWLWLWLWWWWWWWWWLWLWWWLWLWLWWWLWLWLW
WLWLWLLLLLLLLLLLWLWLWLWLLLLLWLLLWLLLLLLLWLWLLLWLWLWLWLLLWLLLW
WLWLWLWWWWWWWWWLWLWLWWWWWLWWWWWWWLWWWWWLWLWWWLWLWWWLWLWWWWWLW
WLLLWLLLWLLLWLWLLLWLLLLLLLLLWLLLLLLLWLLLWLWLLLWLLLLLWLWLWLLLW
WLWWWWWLWLWLWLWLWWWWWWWWWLWLWWWWWLWWWLWWWLWLWWWWWWWLWLWLWLWWW
WLWLLLWLWLWLWLLLLLLLLLLLLLWLLLLLWLWLLLWLLLWLLLWLLLWLWLWLWLWLW
WLWLWLWLWLWLWWWWWWWWWWWWWWWWWWWLWWWLWWWLWWWWWLWLWLWWWLWLWLWLW
WLLLWLWLLLWLWLLLLLWLLLWLLLLLWLLLLLWLWLLLWLLLWLWLWLLLLLWLWLWLW
WWWWWLWWWWWWWLWWWLWLWWWLWWWLWLWWWLWLWLWWWLWWWLWLWWWWWLWLWLWLW
WLLLWLLLLLWLLLWLWLLLLLLLWLLLWLWLLLLLWLLLWLWLLLWLLLLLWLLLWLWLW
WLWLWWWWWLWLWWWLWWWWWWWWWLWLWWWLWLWLWWWLWLWLWWWWWWWLWWWWWLWLW
WLWLWLLLLLWLLLWLLLLLLLLLLLWLLLLLWLWLWLLLWLLLWLLLLLWLLLWLLLWLW
WLWLWLWWWWWWWLWWWWWWWWWWWWWWWWWWWLWLWLWWWLWWWLWWWWWWWLWLWWWLW
WLWLWLLLLLWLLLWLWLLLLLWLLLLLLLLLLLWLWLWLWLWLLLLLLLLLLLWLLLLLW
WLWLWLWWWWWLWWWLWLWWWLWLWWWWWWWWWWWWWLWLWLWWWLWWWWWWWWWWWWWLW
WLWLLLWLLLLLWLLLLLWLWLLLWLLLLLWLLLLLWLWLLLWLLLLLWLLLLLWLLLLLW
WLWWWWWLWWWWWLWLWWWLWWWWWWWWWLWLWWWLWLWWWWWLWWWWWLWWWLWWWWWWW
WLWLLLLLWLLLLLWLWLLLWLLLLLLLLLWLWLLLWLLLWLLLWLLLWLLLWLWLLLLLW
WLWLWWWWWLWWWWWLWLWWWLWLWWWWWWWLWLWWWWWLWLWWWWWLWWWWWLWLWWWLW
WLWLWLLLLLWLLLLLWLWLLLWLWLLLLLLLWLWLLLLLWLLLLLWLWLLLLLWLLLWLW
WLWLWLWWWWWLWWWWWLWLWWWLWLWWWWWLWLWLWWWWWWWWWLWLWLWWWWWWWWWLW
WLLLWLLLWLLLWLLLWLLLWLWLLLWLWLLLWLLLWLLLWLLLLLLLWLLLWLLLLLWLW
WWWWWWWLWLWWWWWLWLWWWLWWWWWLWLWWWWWWWWWLWLWWWLWWWLWWWLWWWLWLW
WLLLLLWLWLLLLLLLWLWLLLWLLLLLLLLLWLLLWLLLWLWLLLWLLLWLLLWLWLWLW
WLWWWLWLWWWWWLWWWLWLWWWLWWWLWWWLWLWWWLWWWWWLWWWLWWWLWWWLWLWLW
WLLLWLLLWLLLLLWLLLWLWLLLWLLLWLLLLLWLLLWLWLLLWLLLLLLLWLLLWLLLW
WLWWWWWWWLWWWWWLWWWLWWWWWLWWWLWWWWWLWWWLWLWWWLWWWLWWWLWWWWWWW
WLLLWLLLWLLLLLWLLLWLWLLLLLLLWLWLLLLLLLWLWLLLWLWLWLLLWLWLLLWLW
WWWLWLWLWWWWWLWWWLWLWLWLWWWWWLWWWWWLWLWLWWWLWLWLWWWLWLWLWLWLW
WLLLWLWLLLWLLLWLLLWLLLWLLLLLWLLLLLWLWLWLWLLLLLWLLLWLLLWLWLWLW
WLWWWWWWWLWLWWWLWWWWWWWWWWWLWWWWWLWWWLWLWLWWWLWLWLWLWWWLWLWLW
WLLLLLLLLLWLLLLLWLLLWLLLLLLLLLLLWLWLLLWLWLWLLLWLWLLLLLWLWLWLW
WWWWWWWWWWWWWLWWWLWLWWWWWWWLWWWLWWWLWWWLWWWLWWWLWWWLWWWLWLWLW
WLLLLLLLLLLLLLWLLLWLLLWLLLLLWLWLLLWLWLWLLLLLWLWLLLWLWLLLWLWLW
WLWWWWWWWWWWWWWLWWWWWLWLWWWWWLWWWLWLWLWLWWWWWLWWWLWLWLWWWLWLW
WLLLWLLLLLWLLLWLLLLLWLLLWLLLWLLLLLLLWLWLWLLLLLLLLLWLWLWLLLWLW
WWWLWLWWWLWWWLWWWWWLWWWWWLWLWWWWWWWWWLWLWWWWWLWWWWWLWLWLWWWLW
WLLLWLWLWLLLWLLLLLLLLLWLLLWLLLWLWLLLLLWLLLLLWLWLLLWLLLWLLLLLW
WLWWWLWLWWWLWWWWWWWLWLWLWWWWWLWLWLWWWWWWWLWLWLWLWWWLWWWLWWWLW
WLLLWLWLLLWLWLLLLLWLWLLLWLWLLLLLWLLLLLLLWLWLWLWLLLLLWLWLWLLLW
WLWLWLWWWLWLWLWWWLWLWWWWWLWLWWWWWWWWWWWLWWWLWLWWWWWWWLWLWWWWW
WLWLLLWLWLLLWLLLWLLLLLLLLLWLLLWLLLLLWLWLWLLLWLLLLLLLWLWLWLLLW
WLWWWWWLWWWWWWWLWWWLWWWWWLWWWLWLWLWLWLWLWLWWWWWWWWWLWLWLWLWLW
WLLLLLLLWLLLLLLLWLLLWLLLLLWLLLLLWLWLLLWLLLWLLLLLLLLLLLWLLLWFW
WWWWWWWWWWWWWWWWWWWWWWWWWWWWWWWWWWWWWWWWWWWWWWWWWWWWWWWWWWWWW
