41,41
39,39
WWWWWWWWWWWWWWWWWWWWWWWWWWWWWWWWWWWWWWWWW
WFLLWLLLWLLLLLLLLLWLLLLLLLWLLLWLLLLLLLLLW
WLWLWLWLWLWWWWWWWLWLWWWWWLWLWLWLWWWWWWWLW
WLWLLLWLWLLLWLLLWLWLLLLLWLWLWLWLWLLLLLWLW
WLWLWWWLWLWWWLWLWLWWWWWWWLWLWLWLWWWLWWWLW
WLWLWLLLLLWLLLWLWLLLLLLLLLWLWLLLLLWLLLLLW
WLWLWLWWWWWLWWWWWWWWWWWWWWWLWWWWWLWWWWWWW
WLWLWLWLLLLLLLWLLLWLLLWLLLLLWLLLWLWLLLLLW
WLWLWLWLWWWWWLWLWLWWWLWLWWWWWLWWWLWLWWWLW
WLWLWLLLWLLLWLWLWLLLLLWLLLLLLLWLLLWLWLLLW
WLWLWWWWWLWLWWWLWWWWWWWWWWWWWWWLWLWLWLWWW
WLWLLLLLLLWLLLWLLLLLLLLLLLWLLLWLWLLLWLWLW
WLWWWWWWWWWWWLWWWWWLWWWWWLWLWWWLWWWWWLWLW
WLWLWLLLWLLLLLWLLLWLWLLLWLLLLLWLLLWLWLLLW
WLWLWLWWWLWWWWWLWLWWWLWLWWWWWLWLWLWLWWWLW
WLLLWLLLLLLLWLLLWLWLLLWLLLLLLLWLWLWLLLWLW
WWWWWWWWWLWLWLWWWLWLWWWWWWWWWWWLWLWLWLWWW
WLLLLLLLLLWLLLWLLLWLLLLLWLLLWLLLWLWLWLLLW
WLWWWWWWWWWWWWWLWWWWWWWLWLWLWLWWWLWLWWWLW
WLLLWLWLLLLLLLWLWLLLLLWLWLWLLLWLWLLLWLLLW
WWWLWLWLWWWLWWWLWWWLWWWLWLWWWWWLWLWWWWWWW
WLWLWLWLLLWLWLLLWLLLLLLLWLLLLLWLWLWLLLLLW
WLWLWLWWWLWLWLWLWLWWWWWWWWWWWLWLWLWLWWWLW
WLWLWLLLLLWLWLWLLLWLLLWLLLLLLLWLLLWLWLWLW
WLWLWLWWWWWLWLWWWWWLWLWLWLWWWWWWWWWLWLWLW
WLLLWLLLLLWLWLLLWLLLWLLLWLLLWLLLLLWLLLWLW
WWWWWLWWWLWLWWWLWLWWWWWWWWWLWWWWWLWWWLWLW
WLLLLLWLLLWLWLLLWLLLLLWLLLWLLLLLWLLLWLWLW
WLWWWWWLWWWLWLWLWWWWWLWWWLWWWWWLWWWLWWWLW
WLLLLLWLLLWLLLWLLLLLLLWLLLLLWLLLWLLLLLWLW
WWWWWLWWWLWWWLWWWWWWWWWLWWWWWLWWWWWLWLWLW
WLLLWLLLWLLLWLLLLLLLLLWLWLLLLLWLLLLLWLWLW
WLWLWWWLWWWLWWWWWWWWWLWLWLWWWWWLWWWWWLWLW
WLWLWLWLWLLLWLLLLLLLWLLLWLWLLLLLWLWLLLWLW
WLWLWLWLWLWLWWWWWWWLWWWWWLWLWWWWWLWLWWWLW
WLWLWLLLWLWLLLLLLLWLWLLLWLWLWLLLWLLLWLLLW
WLWLWLWWWWWWWWWWWLWLWLWWWLWLWLWLWWWLWLWLW
WLWLWLWLWLLLLLLLWLWLLLLLLLWLLLWLLLWLWLWLW
WLWWWLWLWLWLWWWLWLWWWLWWWWWWWWWWWLWLWLWLW
WLLLLLWLLLWLLLWLLLLLWLLLLLLLLLLLLLWLLLWIW
WWWWWWWWWWWWWWWWWWWWWWWWWWWWWWWWWWWWWWWWW
